#########################################
#...#.....#.............#.....#.....#...#
#.#.#.#.#.###.###.#####.###.#.###.#.#.#.#
#.#...#.#...#.#...#...#...#.#.....#...#.#
#.#####.###.###.###.#####.#.###########.#
#.....#...#.....#.......#...#...#.#.....#
#####.###.###########.#.#####.#.#.#.#####
#.......#...#...#...#.#.#.....#.#.#.....#
#######.###.#.#.#.#.###.#.###.#.#.#####.#
#...#....X#...#.#.#...#...#.#.#...#.....#
#.#.###########.#.###.#.###.#.#####.#####
#.#.............#.#.#.#.#...#.......#...#
#.#############.#.#.#.#.#.#######.#####.#
#.#.....#.......#.#.#.#.#.#.....#.....#.#
#.#.###.#.#######.#.#.#.#.#.###.#####.#.#
#.#...#.........#.#.#.#...#.#.#.#...#...#
#.#############.#.#.#.###.#.#.#.#.#####.#
#.#...#.......#.#...#...#.#...#.#.......#
#.#.#.#.#####.#####.###.#####.#.###.#####
#...#...#...#.........#.#...#.#...#.#...#
#########.#############.#.#.#.###.#.#.#.#
#...#.........#......0#...#.....#.#...#.#
#.###.#####.#.#.#######.#########.#####.#
#...#.#...#.#.#.....#.......#.....#...#.#
#.#.#.###.#.#######.#.#######.#####.###.#
#.#.#.#...#.......#.#.#.....#.#.....#...#
###.#.#.#.#######.#.###.###.#.#.#####.###
#...#.#.#.#.....#.#...#.#.#...#...#...#.#
#.#.#.#.#.#.###.#.###.#.#.#####.#.#.###.#
#.#.#...#.#.#.....#.#...#.......#.#.#...#
#.#######.#.#####.#.#####.#######.#.###.#
#.#.....#.#.....#...#...#...#.#...#.....#
#.#.###.#.#####.#.###.#.###.#.#.#######.#
#.....#.#...#.#.#.#...#...#.#.#.....#.#.#
#######.###.#.#.###.#####.#.#.###.#.#.#.#
#.......#...#.#.....#...#.#.#...#.#...#.#
#.#######.###.#########.#.#.#.###.#####.#
#.........#...#.........#.#...#...#...#.#
#.#########.#.#####.###.#.###.#.###.#.#.#
#...........#.......#...#.....#.....#...#
#########################################
